"filename", "language", "C", "CMake", "C++", "x86 and x86_64 Assembly", "comment", "blank", "total"
"e:\ubuntu\diy-x86os\start\start\source\applib\CMakeLists.txt", "CMake", 0, 9, 0, 0, 0, 3, 12
"e:\ubuntu\diy-x86os\start\start\source\applib\crt0.S", "x86 and x86_64 Assembly", 0, 0, 0, 10, 0, 1, 11
"e:\ubuntu\diy-x86os\start\start\source\applib\cstart.c", "C", 16, 0, 0, 0, 8, 2, 26
"e:\ubuntu\diy-x86os\start\start\source\applib\lib_syscall.c", "C", 208, 0, 0, 0, 0, 17, 225
"e:\ubuntu\diy-x86os\start\start\source\applib\lib_syscall.h", "C", 49, 0, 0, 0, 8, 16, 73
"e:\ubuntu\diy-x86os\start\start\source\boot\CMakeLists.txt", "CMake", 0, 15, 0, 0, 0, 4, 19
"e:\ubuntu\diy-x86os\start\start\source\boot\boot.c", "C", 6, 0, 0, 0, 14, 4, 24
"e:\ubuntu\diy-x86os\start\start\source\boot\boot.h", "C++", 0, 0, 3, 0, 10, 2, 15
"e:\ubuntu\diy-x86os\start\start\source\boot\start.S", "x86 and x86_64 Assembly", 0, 0, 0, 40, 0, 6, 46
"e:\ubuntu\diy-x86os\start\start\source\comm\boot_info.h", "C", 14, 0, 0, 0, 0, 7, 21
"e:\ubuntu\diy-x86os\start\start\source\comm\cpu_instr.h", "C", 119, 0, 0, 0, 0, 18, 137
"e:\ubuntu\diy-x86os\start\start\source\comm\elf.h", "C++", 0, 0, 43, 0, 2, 13, 58
"e:\ubuntu\diy-x86os\start\start\source\comm\types.h", "C", 7, 0, 0, 0, 0, 2, 9
"e:\ubuntu\diy-x86os\start\start\source\init\CMakeLists.txt", "CMake", 0, 20, 0, 0, 0, 5, 25
"e:\ubuntu\diy-x86os\start\start\source\init\main.c", "C", 15, 0, 0, 0, 8, 4, 27
"e:\ubuntu\diy-x86os\start\start\source\init\main.h", "C", 23, 0, 0, 0, 8, 12, 43
"e:\ubuntu\diy-x86os\start\start\source\kernel\CMakeLists.txt", "CMake", 0, 16, 0, 0, 0, 3, 19
"e:\ubuntu\diy-x86os\start\start\source\kernel\core\memory.c", "C", 315, 0, 0, 0, 39, 56, 410
"e:\ubuntu\diy-x86os\start\start\source\kernel\core\syscall.c", "C", 54, 0, 0, 0, 0, 11, 65
"e:\ubuntu\diy-x86os\start\start\source\kernel\core\task.c", "C", 740, 0, 0, 0, 44, 75, 859
"e:\ubuntu\diy-x86os\start\start\source\kernel\cpu\cpu.c", "C", 78, 0, 0, 0, 13, 9, 100
"e:\ubuntu\diy-x86os\start\start\source\kernel\cpu\irq.c", "C", 311, 0, 0, 0, 1, 21, 333
"e:\ubuntu\diy-x86os\start\start\source\kernel\cpu\mmu.c", "C", 0, 0, 0, 0, 8, 1, 9
"e:\ubuntu\diy-x86os\start\start\source\kernel\dev\console.c", "C", 345, 0, 0, 0, 23, 27, 395
"e:\ubuntu\diy-x86os\start\start\source\kernel\dev\dev.c", "C", 93, 0, 0, 0, 5, 17, 115
"e:\ubuntu\diy-x86os\start\start\source\kernel\dev\disk.c", "C", 238, 0, 0, 0, 6, 21, 265
"e:\ubuntu\diy-x86os\start\start\source\kernel\dev\kbd.c", "C", 211, 0, 0, 0, 23, 12, 246
"e:\ubuntu\diy-x86os\start\start\source\kernel\dev\time.c", "C", 26, 0, 0, 0, 8, 4, 38
"e:\ubuntu\diy-x86os\start\start\source\kernel\dev\tty.c", "C", 206, 0, 0, 0, 8, 16, 230
"e:\ubuntu\diy-x86os\start\start\source\kernel\fs\devfs\devfs.c", "C", 85, 0, 0, 0, 0, 5, 90
"e:\ubuntu\diy-x86os\start\start\source\kernel\fs\fatfs\fatfs.c", "C", 628, 0, 0, 0, 25, 69, 722
"e:\ubuntu\diy-x86os\start\start\source\kernel\fs\file.c", "C", 41, 0, 0, 0, 8, 9, 58
"e:\ubuntu\diy-x86os\start\start\source\kernel\fs\fs.c", "C", 404, 0, 0, 0, 8, 29, 441
"e:\ubuntu\diy-x86os\start\start\source\kernel\include\core\memory.h", "C", 42, 0, 0, 0, 8, 8, 58
"e:\ubuntu\diy-x86os\start\start\source\kernel\include\core\syscall.h", "C++", 0, 0, 52, 0, 8, 8, 68
"e:\ubuntu\diy-x86os\start\start\source\kernel\include\core\task.h", "C", 97, 0, 0, 0, 8, 27, 132
"e:\ubuntu\diy-x86os\start\start\source\kernel\include\cpu\cpu.h", "C++", 0, 0, 60, 0, 8, 15, 83
"e:\ubuntu\diy-x86os\start\start\source\kernel\include\cpu\irq.h", "C++", 0, 0, 90, 0, 0, 23, 113
"e:\ubuntu\diy-x86os\start\start\source\kernel\include\cpu\mmu.h", "C++", 0, 0, 71, 0, 0, 8, 79
"e:\ubuntu\diy-x86os\start\start\source\kernel\include\dev\console.h", "C++", 0, 0, 86, 0, 0, 11, 97
"e:\ubuntu\diy-x86os\start\start\source\kernel\include\dev\dev.h", "C++", 0, 0, 35, 0, 0, 7, 42
"e:\ubuntu\diy-x86os\start\start\source\kernel\include\dev\disk.h", "C", 83, 0, 0, 0, 0, 21, 104
"e:\ubuntu\diy-x86os\start\start\source\kernel\include\dev\kbd.h", "C++", 0, 0, 58, 0, 0, 13, 71
"e:\ubuntu\diy-x86os\start\start\source\kernel\include\dev\time.h", "C++", 0, 0, 11, 0, 0, 5, 16
"e:\ubuntu\diy-x86os\start\start\source\kernel\include\dev\tty.h", "C++", 0, 0, 37, 0, 8, 6, 51
"e:\ubuntu\diy-x86os\start\start\source\kernel\include\fs\devfs\devfs.h", "C++", 0, 0, 11, 0, 0, 4, 15
"e:\ubuntu\diy-x86os\start\start\source\kernel\include\fs\fatfs\fatfs.h", "C++", 0, 0, 72, 0, 3, 16, 91
"e:\ubuntu\diy-x86os\start\start\source\kernel\include\fs\file.h", "C", 32, 0, 0, 0, 8, 8, 48
"e:\ubuntu\diy-x86os\start\start\source\kernel\include\fs\fs.h", "C", 62, 0, 0, 0, 0, 9, 71
"e:\ubuntu\diy-x86os\start\start\source\kernel\include\ipc\mutex.h", "C++", 0, 0, 14, 0, 0, 9, 23
"e:\ubuntu\diy-x86os\start\start\source\kernel\include\ipc\sem.h", "C++", 0, 0, 13, 0, 0, 3, 16
"e:\ubuntu\diy-x86os\start\start\source\kernel\include\os_cfg.h", "C++", 0, 0, 14, 0, 8, 9, 31
"e:\ubuntu\diy-x86os\start\start\source\kernel\include\tools\bitmap.h", "C++", 0, 0, 15, 0, 8, 6, 29
"e:\ubuntu\diy-x86os\start\start\source\kernel\include\tools\klib.h", "C", 31, 0, 0, 0, 8, 7, 46
"e:\ubuntu\diy-x86os\start\start\source\kernel\include\tools\list.h", "C++", 0, 0, 54, 0, 0, 12, 66
"e:\ubuntu\diy-x86os\start\start\source\kernel\include\tools\log.h", "C", 5, 0, 0, 0, 0, 5, 10
"e:\ubuntu\diy-x86os\start\start\source\kernel\init\first_task.c", "C", 62, 0, 0, 0, 14, 3, 79
"e:\ubuntu\diy-x86os\start\start\source\kernel\init\first_task_entry.S", "x86 and x86_64 Assembly", 0, 0, 0, 10, 0, 1, 11
"e:\ubuntu\diy-x86os\start\start\source\kernel\init\init.c", "C", 57, 0, 0, 0, 14, 12, 83
"e:\ubuntu\diy-x86os\start\start\source\kernel\init\init.h", "C++", 0, 0, 3, 0, 0, 5, 8
"e:\ubuntu\diy-x86os\start\start\source\kernel\init\lib_syscall.c", "C", 150, 0, 0, 0, 0, 12, 162
"e:\ubuntu\diy-x86os\start\start\source\kernel\init\start.S", "x86 and x86_64 Assembly", 0, 0, 0, 449, 0, 102, 551
"e:\ubuntu\diy-x86os\start\start\source\kernel\ipc\mutex.c", "C", 49, 0, 0, 0, 8, 6, 63
"e:\ubuntu\diy-x86os\start\start\source\kernel\ipc\sem.c", "C", 47, 0, 0, 0, 0, 4, 51
"e:\ubuntu\diy-x86os\start\start\source\kernel\tools\bitmap.c", "C", 65, 0, 0, 0, 0, 2, 67
"e:\ubuntu\diy-x86os\start\start\source\kernel\tools\klib.c", "C", 244, 0, 0, 0, 3, 14, 261
"e:\ubuntu\diy-x86os\start\start\source\kernel\tools\list.c", "C", 78, 0, 0, 0, 8, 6, 92
"e:\ubuntu\diy-x86os\start\start\source\kernel\tools\log.c", "C", 49, 0, 0, 0, 13, 12, 74
"e:\ubuntu\diy-x86os\start\start\source\loader\CMakeLists.txt", "CMake", 0, 15, 0, 0, 0, 3, 18
"e:\ubuntu\diy-x86os\start\start\source\loader\loader.h", "C++", 0, 0, 17, 0, 0, 8, 25
"e:\ubuntu\diy-x86os\start\start\source\loader\loader_16.c", "C", 66, 0, 0, 0, 9, 13, 88
"e:\ubuntu\diy-x86os\start\start\source\loader\loader_32.c", "C", 91, 0, 0, 0, 0, 6, 97
"e:\ubuntu\diy-x86os\start\start\source\loader\start.S", "x86 and x86_64 Assembly", 0, 0, 0, 29, 0, 6, 35
"e:\ubuntu\diy-x86os\start\start\source\loop\CMakeLists.txt", "CMake", 0, 20, 0, 0, 0, 5, 25
"e:\ubuntu\diy-x86os\start\start\source\loop\main.c", "C", 58, 0, 0, 0, 8, 4, 70
"e:\ubuntu\diy-x86os\start\start\source\loop\main.h", "C", 23, 0, 0, 0, 8, 12, 43
"e:\ubuntu\diy-x86os\start\start\source\shell\CMakeLists.txt", "CMake", 0, 20, 0, 0, 0, 5, 25
"e:\ubuntu\diy-x86os\start\start\source\shell\main.c", "C", 354, 0, 0, 0, 9, 12, 375
"e:\ubuntu\diy-x86os\start\start\source\shell\main.h", "C", 23, 0, 0, 0, 8, 12, 43
"Total", "-", 6000, 115, 759, 538, 454, 1006, 8872